0 0 0 0 0 0 0 0 0 0
0 0 3 3 0 0 0 1 0 0
0 0 0 0 0 12 0 1 1 0
0 0 0 0 0 12 0 1 0 0
0 0 0 0 0 12 12 0 0 0
0 14 14 14 0 0 0 0 0 0
0 14 14 0 0 0 0 0 5 0
0 0 14 0 0 0 0 0 0 0
0 0 0 0 0 0 0 0 0 0